%%%%%%%%%%%%%%%%%%%%
%P      G   o      %
% %%%%% %%%%%% % % %
%     G            %
%          G       %
%    ...   %%%%%   %
%                  % 
%   %%%% % . %     %
%    G   % . %     %
%        % . %%%%  %
%        % o       %
% .....            %
%%%%%%%%%%%%%%%%%%%%
% % % % %%%%%%%%%%%%
%%%%%%%%%%%%%%%%%%%%